ん ン n
わ ワ wa
 ら ラ ra
  や ヤ ya
ま マ
ma	は ハ
ha	な ナ
na	た タ
ta	さ サ
sa	か カ
ka	あ ア
a
り リ
ri	み ミ
mi	ひ ヒ
hi	に ニ
ni	ち チ
chi	し シ
shi	き キ
ki	い イ
i
る ル
ru	ゆ ユ
yu	む ム
mu	ふ フ
fu	ぬ ヌ
nu	つ ツ
tsu	す ス
su	く ク
ku	う ウ
u
れ レ
re		め メ
me	へ ヘ
he	ね ネ
ne	て テ
te	せ セ
se	け ケ
ke	え エ
e
を ヲ
wo	ろ ロ
ro	よ ヨ
yo	も モ
mo	ほ ホ
ho	の ノ
no	と ト
to	そ ソ
so	こ コ
ko	お オ
o